16,16
WC,0,X,X,X
WC,0,X,X,X
WC,0,X,X,X
WC,0,X,X,X
WC,0,X,X,X
WC,0,X,X,X
WC,0,X,X,X
WC,0,X,X,X
WC,0,X,X,X
WC,0,X,X,X
WC,0,X,X,X
WC,0,X,X,X
WC,0,X,X,X
WC,0,X,X,X
WC,0,X,X,X
WC,0,X,X,X
WC,0,X,X,X
GC,1,X,X
U,D
GC,0,X,X,X
WC,0,X,X,X
GC,0,X,X,X
GC,0,X,X,X
GC,0,X,X,X
GC,0,X,X,X
GC,0,X,X,X
GC,0,X,X,X
GC,0,X,X,X
GC,0,X,X,X
GC,0,X,X,X
GC,0,X,X,X
GC,0,X,X,X
WC,0,X,X,X
WC,0,X,X,X
GC,0,X,X,X
GC,0,X,X,X
WC,0,X,X,X
GC,0,X,X,X
TC,0,X,X,X
GC,0,X,X,X
GC,0,X,X,X
GC,0,X,X,X
GC,0,X,X,X
GC,0,X,X,X
GC,0,X,X,X
GC,0,X,X,X
GC,0,X,X,X
GC,0,X,X,X
WC,0,X,X,X
WC,0,X,X,X
GC,0,X,X,X
GC,0,X,X,X
WC,0,X,X,X
GC,0,X,X,X
GC,0,X,X,X
GC,0,X,X,X
GC,0,X,X,X
GC,0,X,X,X
GC,0,X,X,X
GC,0,X,X,X
GC,0,X,X,X
GC,0,X,X,X
GC,0,X,X,X
GC,0,X,X,X
WC,0,X,X,X
WC,0,X,X,X
GC,0,X,X,X
WC,0,X,X,X
WC,0,X,X,X
GC,0,X,X,X
GC,0,X,X,X
GC,0,X,X,X
GC,0,X,X,X
GC,0,X,X,X
GC,0,X,X,X
GC,0,X,X,X
GC,0,X,X,X
GC,0,X,X,X
GC,0,X,X,X
GC,1,X,X
SLE,U
WC,0,X,X,X
WC,0,X,X,X
GC,0,X,X,X
GC,0,X,X,X
GC,0,X,X,X
GC,0,X,X,X
GC,0,X,X,X
YD,0,X,X,X
GC,0,X,X,X
GC,0,X,X,X
TD1,0,X,X,X
GC,0,X,X,X
GC,0,X,X,X
GC,0,X,X,X
FC,0,X,X,X
GC,0,X,X,X
WC,0,X,X,X
WC,0,X,X,X
WC,0,X,X,X
WC,0,X,X,X
WC,0,X,X,X
WC,0,X,X,X
WC,0,X,X,X
WC,0,X,X,X
WC,0,X,X,X
WC,0,X,X,X
GC,1,X,X
SLE,U
WC,0,X,X,X
WC,0,X,X,X
WC,0,X,X,X
WC,0,X,X,X
WC,0,X,X,X
WC,0,X,X,X
WC,0,X,X,X
GC,0,X,X,X
GC,0,X,X,X
GC,0,X,X,X
GC,0,X,X,X
GC,0,X,X,X
GC,0,X,X,X
GC,0,X,X,X
GC,0,X,X,X
GC,0,X,X,X
GC,0,X,X,X
GC,0,X,X,X
GC,0,X,X,X
GC,0,X,X,X
GC,0,X,X,X
WC,0,X,X,X
WC,0,X,X,X
GC,0,X,X,X
GC,0,X,X,X
GC,0,X,X,X
GC,0,X,X,X
GOC,0,X,X,X
GC,0,X,X,X
TC,0,X,X,X
GC,0,X,X,X
GC,0,X,X,X
GC,0,X,X,X
GC,0,X,X,X
GC,0,X,X,X
GC,0,X,X,X
GC,0,X,X,X
WC,0,X,X,X
WC,0,X,X,X
GC,0,X,X,X
GC,0,X,X,X
GC,0,X,X,X
GC,0,X,X,X
GC,0,X,X,X
GC,0,X,X,X
GC,0,X,X,X
GC,0,X,X,X
GC,0,X,X,X
GC,0,X,X,X
GC,0,X,X,X
GC,0,X,X,X
GC,0,X,X,X
GC,0,X,X,X
WC,0,X,X,X
WC,0,X,X,X
GC,0,X,X,X
GC,0,X,X,X
GC,0,X,X,X
GC,0,X,X,X
GC,0,X,X,X
GC,0,X,X,X
GC,0,X,X,X
GC,0,X,X,X
GC,0,X,X,X
GC,0,TKI,X,X
GC,0,X,X,X
GC,0,X,X,X
GC,0,X,X,X
GC,0,X,X,X
WC,0,X,X,X
WC,0,X,X,X
GC,0,X,X,X
GC,0,X,X,X
GC,0,X,X,X
GC,0,FBI,X,X
GC,0,X,X,X
GC,0,X,X,X
GC,0,X,X,X
GC,0,X,X,X
GC,0,X,X,X
GC,0,X,X,X
GC,0,X,X,X
GC,0,X,X,X
GC,0,X,X,X
GC,0,YKI,X,X
WC,0,X,X,X
WC,0,X,X,X
GC,0,X,X,X
GC,0,X,X,X
GC,0,X,X,X
GC,0,X,X,X
GC,0,X,X,X
GC,0,X,X,X
GC,0,X,X,X
GC,0,X,X,X
GC,0,X,X,X
GC,0,X,X,X
GC,0,X,X,X
GC,0,X,X,X
GC,0,X,X,X
GC,0,X,X,X
WC,0,X,X,X
WC,0,X,X,X
GC,0,X,X,X
GC,0,X,X,X
GC,0,X,X,X
GC,0,X,X,X
GC,0,X,X,X
GC,0,X,X,X
GC,0,X,X,X
GC,0,X,X,X
GC,0,X,X,X
GC,0,X,X,X
GC,0,X,X,X
GC,0,X,X,X
GC,0,X,X,X
GC,0,X,X,X
WC,0,X,X,X
WC,0,X,X,X
GC,0,X,X,X
GC,0,X,X,X
GC,0,X,X,X
GC,0,X,X,X
GC,0,X,X,X
GC,0,X,X,X
GC,0,X,X,X
GC,0,X,X,X
GC,0,X,X,X
GC,0,X,X,X
GC,0,X,X,X
GC,0,X,X,X
GC,0,X,X,X
GC,0,X,X,X
WC,0,X,X,X
WC,0,X,X,X
WC,0,X,X,X
WC,0,X,X,X
WC,0,X,X,X
WC,0,X,X,X
WC,0,X,X,X
WC,0,X,X,X
WC,0,X,X,X
WC,0,X,X,X
WC,0,X,X,X
WC,0,X,X,X
WC,0,X,X,X
WC,0,X,X,X
WC,0,X,X,X
WC,0,X,X,X
WC,0,X,X,X