16,16
WC,X,X,X,X
WC,X,X,X,X
WC,X,X,X,X
WC,X,X,X,X
WC,X,X,X,X
WC,X,X,X,X
WC,X,X,X,X
WC,X,X,X,X
WC,X,X,X,X
WC,X,X,X,X
WC,X,X,X,X
WC,X,X,X,X
WC,X,X,X,X
WC,X,X,X,X
WC,X,X,X,X
WC,X,X,X,X
WC,X,X,X,X
GC,U,X,X,X
GC,X,X,X,X
WC,X,X,X,X
GC,X,X,X,X
GC,X,X,X,X
GC,X,X,X,X
GC,X,X,X,X
GC,X,X,X,X
GC,X,X,X,X
GC,X,X,X,X
GC,X,X,X,X
GC,X,X,X,X
GC,X,X,X,X
GC,X,X,X,X
WC,X,X,X,X
WC,X,X,X,X
GC,X,X,X,X
GC,X,X,X,X
WC,X,X,X,X
GC,X,X,X,X
GC,X,X,X,X
GC,X,X,X,X
GC,X,X,X,X
GC,X,X,X,X
GC,X,X,X,X
GC,X,X,X,X
GC,X,X,X,X
GC,X,X,X,X
GC,X,X,X,X
GC,X,X,X,X
WC,X,X,X,X
WC,X,X,X,X
GC,X,X,X,X
GC,X,X,X,X
WC,X,X,X,X
GC,X,X,X,X
GC,X,X,X,X
GC,X,X,X,X
GC,X,X,X,X
GC,X,X,X,X
GC,X,X,X,X
GC,X,X,X,X
GC,X,X,X,X
GC,X,X,X,X
GC,X,X,X,X
GC,X,X,X,X
WC,X,X,X,X
WC,X,X,X,X
GC,X,X,X,X
WC,X,X,X,X
WC,X,X,X,X
GC,X,X,X,X
GC,X,X,X,X
GC,X,X,X,X
GC,X,X,X,X
GC,X,X,X,X
GC,X,X,X,X
GC,X,X,X,X
GC,X,X,X,X
GC,X,X,X,X
GC,X,X,X,X
GC,SLE,X,X,X
WC,X,X,X,X
WC,X,X,X,X
GC,X,X,X,X
GC,X,X,X,X
GC,X,X,X,X
GC,X,X,X,X
GC,X,X,X,X
GC,X,X,X,X
GC,X,X,X,X
GC,X,X,X,X
GC,X,X,X,X
GC,X,X,X,X
GC,X,X,X,X
GC,X,X,X,X
GC,X,X,X,X
GC,X,X,X,X
WC,X,X,X,X
WC,X,X,X,X
WC,X,X,X,X
WC,X,X,X,X
WC,X,X,X,X
WC,X,X,X,X
WC,X,X,X,X
WC,X,X,X,X
WC,X,X,X,X
WC,X,X,X,X
GC,SLE,X,X,X
WC,X,X,X,X
WC,X,X,X,X
WC,X,X,X,X
WC,X,X,X,X
WC,X,X,X,X
WC,X,X,X,X
WC,X,X,X,X
GC,X,X,X,X
GC,X,X,X,X
GC,X,X,X,X
GC,X,X,X,X
GC,X,X,X,X
GC,X,X,X,X
GC,X,X,X,X
GC,X,X,X,X
GC,X,X,X,X
GC,X,X,X,X
GC,X,X,X,X
GC,X,X,X,X
GC,X,X,X,X
GC,X,X,X,X
WC,X,X,X,X
WC,X,X,X,X
GC,X,X,X,X
GC,X,X,X,X
GC,X,X,X,X
GC,X,X,X,X
GC,X,X,X,X
GC,X,X,X,X
GC,X,X,X,X
GC,X,X,X,X
GC,X,X,X,X
GC,X,X,X,X
GC,X,X,X,X
GC,X,X,X,X
GC,X,X,X,X
GC,X,X,X,X
WC,X,X,X,X
WC,X,X,X,X
GC,X,X,X,X
GC,X,X,X,X
GC,X,X,X,X
GC,X,X,X,X
GC,X,X,X,X
GC,X,X,X,X
GC,X,X,X,X
GC,X,X,X,X
GC,X,X,X,X
GC,X,X,X,X
GC,X,X,X,X
GC,X,X,X,X
GC,X,X,X,X
GC,X,X,X,X
WC,X,X,X,X
WC,X,X,X,X
GC,X,X,X,X
GC,X,X,X,X
GC,X,X,X,X
GC,X,X,X,X
GC,X,X,X,X
GC,X,X,X,X
GC,X,X,X,X
GC,X,X,X,X
GC,X,X,X,X
GC,X,X,X,X
GC,X,X,X,X
GC,X,X,X,X
GC,X,X,X,X
GC,X,X,X,X
WC,X,X,X,X
WC,X,X,X,X
GC,X,X,X,X
GC,X,X,X,X
GC,X,X,X,X
GC,X,X,X,X
GC,X,X,X,X
GC,X,X,X,X
GC,X,X,X,X
GC,X,X,X,X
GC,X,X,X,X
GC,X,X,X,X
GC,X,X,X,X
GC,X,X,X,X
GC,X,X,X,X
GC,X,X,X,X
WC,X,X,X,X
WC,X,X,X,X
GC,X,X,X,X
GC,X,X,X,X
GC,X,X,X,X
GC,X,X,X,X
GC,X,X,X,X
GC,X,X,X,X
GC,X,X,X,X
GC,X,X,X,X
GC,X,X,X,X
GC,X,X,X,X
GC,X,X,X,X
GC,X,X,X,X
GC,X,X,X,X
GC,X,X,X,X
WC,X,X,X,X
WC,X,X,X,X
GC,X,X,X,X
GC,X,X,X,X
GC,X,X,X,X
GC,X,X,X,X
GC,X,X,X,X
GC,X,X,X,X
GC,X,X,X,X
GC,X,X,X,X
GC,X,X,X,X
GC,X,X,X,X
GC,X,X,X,X
GC,X,X,X,X
GC,X,X,X,X
GC,X,X,X,X
WC,X,X,X,X
WC,X,X,X,X
GC,X,X,X,X
GC,X,X,X,X
GC,X,X,X,X
GC,X,X,X,X
GC,X,X,X,X
GC,X,X,X,X
GC,X,X,X,X
GC,X,X,X,X
GC,X,X,X,X
GC,X,X,X,X
GC,X,X,X,X
GC,X,X,X,X
GC,X,X,X,X
GC,X,X,X,X
WC,X,X,X,X
WC,X,X,X,X
WC,X,X,X,X
WC,X,X,X,X
WC,X,X,X,X
WC,X,X,X,X
WC,X,X,X,X
WC,X,X,X,X
WC,X,X,X,X
WC,X,X,X,X
WC,X,X,X,X
WC,X,X,X,X
WC,X,X,X,X
WC,X,X,X,X
WC,X,X,X,X
WC,X,X,X,X
WC,X,X,X,X