16,16
WC,X,X,X,X
WC,X,X,X,X
WC,X,X,X,X
WC,X,X,X,X
WC,X,X,X,X
WC,X,X,X,X
WC,X,X,X,X
WC,X,X,X,X
WC,X,X,X,X
WC,X,X,X,X
WC,X,X,X,X
WC,X,X,X,X
WC,X,X,X,X
WC,X,X,X,X
WC,X,X,X,X
WC,X,X,X,X
WC,X,X,X,X
GC,U,D,X,X
GC,X,X,X,X
WC,X,X,X,X
GC,X,X,X,X
GC,X,X,X,X
GC,X,X,X,X
GC,X,X,X,X
GC,X,X,X,X
GC,X,X,X,X
GC,X,X,X,X
GC,X,X,X,X
GC,X,X,X,X
GC,X,X,X,X
GC,X,X,X,X
WC,X,X,X,X
WC,X,X,X,X
GC,X,X,X,X
GC,X,X,X,X
WC,X,X,X,X
GC,X,X,X,X
GC,X,X,X,X
GC,X,X,X,X
GC,X,X,X,X
GC,X,X,X,X
GC,X,X,X,X
GC,X,X,X,X
GC,X,X,X,X
GC,X,X,X,X
GC,X,X,X,X
GC,X,X,X,X
WC,X,X,X,X
WC,X,X,X,X
GC,X,X,X,X
GC,X,X,X,X
WC,X,X,X,X
GC,X,X,X,X
GC,X,X,X,X
GC,X,X,X,X
GC,X,X,X,X
GC,X,X,X,X
GC,X,X,X,X
GC,X,X,X,X
GC,X,X,X,X
GC,X,X,X,X
GC,X,X,X,X
GC,X,X,X,X
WC,X,X,X,X
WC,X,X,X,X
GC,X,X,X,X
WC,X,X,X,X
WC,X,X,X,X
GC,X,X,X,X
GC,X,X,X,X
GC,X,X,X,X
GC,X,X,X,X
GC,X,X,X,X
GC,X,X,X,X
GC,X,X,X,X
GC,X,X,X,X
GC,X,X,X,X
GC,X,X,X,X
GC,WFE,U,X,X
WC,X,X,X,X
WC,X,X,X,X
GC,X,X,X,X
GC,X,X,X,X
GC,X,X,X,X
GC,X,X,X,X
GC,X,X,X,X
GC,X,X,X,X
GC,X,X,X,X
GC,X,X,X,X
GC,X,X,X,X
GC,X,X,X,X
GC,X,X,X,X
GC,X,X,X,X
GC,X,X,X,X
GC,X,X,X,X
WC,X,X,X,X
WC,X,X,X,X
WC,X,X,X,X
WC,X,X,X,X
WC,X,X,X,X
WC,X,X,X,X
WC,X,X,X,X
WC,X,X,X,X
WC,X,X,X,X
WC,X,X,X,X
GC,SLE,U,X,X
WC,X,X,X,X
WC,X,X,X,X
WC,X,X,X,X
WC,X,X,X,X
WC,X,X,X,X
WC,X,X,X,X
WC,X,X,X,X
GC,X,X,X,X
GC,X,X,X,X
GC,X,X,X,X
GC,X,X,X,X
GC,X,X,X,X
GC,X,X,X,X
GC,X,X,X,X
GC,X,X,X,X
GC,X,X,X,X
GC,X,X,X,X
GC,X,X,X,X
GC,X,X,X,X
GC,X,X,X,X
GC,X,X,X,X
WC,X,X,X,X
WC,X,X,X,X
GC,X,X,X,X
GC,X,X,X,X
GC,X,X,X,X
GC,X,X,X,X
GC,X,X,X,X
GC,X,X,X,X
GC,X,X,X,X
GC,X,X,X,X
GC,X,X,X,X
GC,X,X,X,X
GC,X,X,X,X
GC,X,X,X,X
GC,X,X,X,X
GC,X,X,X,X
WC,X,X,X,X
WC,X,X,X,X
GC,X,X,X,X
GC,X,X,X,X
GC,X,X,X,X
GC,X,X,X,X
GC,X,X,X,X
GC,X,X,X,X
GC,X,X,X,X
GC,X,X,X,X
GC,X,X,X,X
GC,X,X,X,X
GC,X,X,X,X
GC,X,X,X,X
GC,X,X,X,X
GC,X,X,X,X
WC,X,X,X,X
WC,X,X,X,X
GC,X,X,X,X
GC,X,X,X,X
GC,X,X,X,X
GC,X,X,X,X
GC,X,X,X,X
GC,X,X,X,X
GC,X,X,X,X
GC,X,X,X,X
GC,X,X,X,X
GC,X,X,X,X
GC,X,X,X,X
GC,X,X,X,X
GC,X,X,X,X
GC,X,X,X,X
WC,X,X,X,X
WC,X,X,X,X
GC,X,X,X,X
GC,X,X,X,X
GC,X,X,X,X
GC,X,X,X,X
GC,X,X,X,X
GC,X,X,X,X
GC,X,X,X,X
GC,X,X,X,X
GC,X,X,X,X
GC,X,X,X,X
GC,X,X,X,X
GC,X,X,X,X
GC,X,X,X,X
GC,X,X,X,X
WC,X,X,X,X
WC,X,X,X,X
GC,X,X,X,X
GC,X,X,X,X
GC,X,X,X,X
GC,X,X,X,X
GC,X,X,X,X
GC,X,X,X,X
GC,X,X,X,X
GC,X,X,X,X
GC,X,X,X,X
GC,X,X,X,X
GC,X,X,X,X
GC,X,X,X,X
GC,X,X,X,X
GC,X,X,X,X
WC,X,X,X,X
WC,X,X,X,X
GC,X,X,X,X
GC,X,X,X,X
GC,X,X,X,X
GC,X,X,X,X
GC,X,X,X,X
GC,X,X,X,X
GC,X,X,X,X
GC,X,X,X,X
GC,X,X,X,X
GC,X,X,X,X
GC,X,X,X,X
GC,X,X,X,X
GC,X,X,X,X
GC,X,X,X,X
WC,X,X,X,X
WC,X,X,X,X
GC,X,X,X,X
GC,X,X,X,X
GC,X,X,X,X
GC,X,X,X,X
GC,X,X,X,X
GC,X,X,X,X
GC,X,X,X,X
GC,X,X,X,X
GC,X,X,X,X
GC,X,X,X,X
GC,X,X,X,X
GC,X,X,X,X
GC,X,X,X,X
GC,X,X,X,X
WC,X,X,X,X
WC,X,X,X,X
WC,X,X,X,X
WC,X,X,X,X
WC,X,X,X,X
WC,X,X,X,X
WC,X,X,X,X
WC,X,X,X,X
WC,X,X,X,X
WC,X,X,X,X
WC,X,X,X,X
WC,X,X,X,X
WC,X,X,X,X
WC,X,X,X,X
WC,X,X,X,X
WC,X,X,X,X
WC,X,X,X,X